11111111111
10011000001
10000000001
1000000E001
10111000001
10000P00001
10000000001
10000000001
10111000001
10000000001
11111111111
