11111111111
1111C00P011
1000C100001
1100C00E001
1011C000101
1011C000001
10111110001
10000P10001
10111110001
100000C0001
100100C0001
100000C0001
1000P00C001
11111111111