11111111111
1111C000011
1000C100001
1100C010001
1011C000101
1011C000001
1111111E001
10001000001
10111111001
100000C1111
100100CPC01
100000C1111
1000100C101
11111111111