1111111111111111111111111
1P00000000000000000000001
1CCC000000000000000000001
1EDD000000000000000000001
1D0000000000000000000CC11
1111111111110000000000001
1111111111111111111111111
