11111111111
10011000011
10000100001
1100000E001
10111000101
10111000001
10111110001
10000P10001
10111110001
100000C0001
100000C0001
100000C0001
10000000001
11111111111