11111111111
1111C000011
1000C100001
1100C00E001
1011C000101
1011C000001
1D111110001
10000010001
10111110001
100000CD001
100100CPC01
100000C0111
1000100C101
11111111111