1111111111111111111111111111111111
1C0000000001E0C0000000000000000001
101001010D101001101001000000010101
1010010010101110001001000000010101
1P0C00000000C00C0001000D0000000001
1111111111111111111111111111111111